4 4 4 4 4 4 4 4
4 4 4 4 4 4 4 4
3 3 3 3 3 3 3 3
3 3 3 1 1 3 3 3
3 3 3 3 3 3 3 3
5 5 5 5 5 5 5 5
5 5 5 5 5 5 5 5